#################################################
#                                  #      #     #
#  ###########################     #      #     #
#                            #     #            #
################################ ###### #########
#                            #                  #
# ############################### ############# #
# #      #      #       #                       #
# #      #      #       #                       #
# ########      #       ##### ################# #
#        #      #       #             #         #
########################### ####### ###         #
#        #              #             #         #
# ######### ##### ############## ################
#              #                      #         #
#################################################
