#################################################
#                                  #      #     #
#  ###########################     #      #     #
#                            #     #            #
####################         ### ###### #########
#                            #                  #
# ## ############################ ############# #
# #      #      #       #                       #
# #             #                               #
# ########      #       ##### ################# #
#        #      #       #             #         #
######## ###### ##### ##### ####### ###         #
#        #              #             #         #
# ######### ##### ############## ########### ####
#              #                      #         #
#################################################
